Date,Campus,Male-Adult,Female-Adult,Kids/Teen,Total,Global total,Comments,unique_id
2024-01-01 00:00:00,Lagos,1082,1630,160,2872,,,1
2024-01-01 00:00:00,Abuja,445,572,30,1047,,,2
2024-01-01 00:00:00,PHC,176,210,21,407,,,3
2024-01-01 00:00:00,Ibadan,214,282,25,521,,,4
2024-01-01 00:00:00,Ife,85,134,0,219,,,5
2024-01-01 00:00:00,Canada,84,127,18,229,,,6
2024-01-08 00:00:00,Lagos,1303,2028,161,3492,,,9
2024-01-08 00:00:00,Abuja,595,1140,48,1783,,,10
2024-01-08 00:00:00,PHC,186,268,20,474,,,11
2024-01-08 00:00:00,Ibadan,214,369,25,608,,,12
2024-01-08 00:00:00,Ife,97,130,3,230,,,13
2024-01-08 00:00:00,Canada,94,126,14,234,,,14
2024-01-08 00:00:00,UK (Birm),33,57,2,92,,,15
2024-01-08 00:00:00,UK (London),71,119,2,192,7105,,16
2024-01-15 00:00:00,Lagos,1461,2046,162,3669,,,17
2024-01-15 00:00:00,Abuja,595,822,46,1463,,,18
2024-01-15 00:00:00,PHC,141,290,33,464,,,19
2024-01-15 00:00:00,Ibadan,326,534,35,895,,,20
2024-01-15 00:00:00,Ife,110,145,4,259,,,21
2024-01-15 00:00:00,Canada,92,125,14,231,,,22
2024-01-15 00:00:00,UK (Birm),47,64,3,114,,,23
2024-01-15 00:00:00,UK (London),66,127,6,199,,,24
2024-01-15 00:00:00,Dallas,18,27,0,45,,,25
2024-01-15 00:00:00,Uyo,135,156,9,300,7639,,26
2024-01-22 00:00:00,Lagos,1594,2315,174,4083,,,27
2024-01-22 00:00:00,Abuja,518,788,53,1359,,,28
2024-01-22 00:00:00,PHC,193,291,24,508,,,29
2024-01-22 00:00:00,Ibadan,247,421,33,701,,,30
2024-01-22 00:00:00,Ife,113,157,4,274,,,31
2024-01-22 00:00:00,Canada,101,170,15,286,,,32
2024-01-22 00:00:00,UK (Birm),50,63,2,115,,,33
2024-01-22 00:00:00,UK (London),58,124,1,183,,,34
2024-01-22 00:00:00,Dallas,18,23,0,41,,,35
2024-01-22 00:00:00,Uyo,81,96,11,188,7738,,36
2024-01-29 00:00:00,Lagos,1966,1597,182,3745,,,37
2024-01-29 00:00:00,Abuja,535,827,87,1449,,,38
2024-01-29 00:00:00,PHC,168,264,27,459,,,39
2024-01-29 00:00:00,Ibadan,231,396,30,657,,,40
2024-01-29 00:00:00,Ife,92,115,2,209,,,41
2024-01-29 00:00:00,Canada,110,138,18,266,,,42
2024-01-29 00:00:00,UK (Birm),51,639,2,692,,,43
2024-01-29 00:00:00,UK (London),62,143,5,210,,,44
2024-01-29 00:00:00,Dallas,20,22,1,43,,,45
2024-01-29 00:00:00,Uyo,86,79,6,171,7901,,46
2024-02-05 00:00:00,Lagos,1461,2073,167,3701,,,47
2024-02-05 00:00:00,Abuja,528,806,64,1398,,,48
2024-02-05 00:00:00,PHC,180,279,22,481,,,49
2024-02-05 00:00:00,Ibadan,246,401,30,677,,,50
2024-02-05 00:00:00,Ife,110,150,4,264,,,51
2024-02-05 00:00:00,Canada,120,169,23,312,,,52
2024-02-05 00:00:00,UK (Birm),63,77,6,146,,,53
2024-02-05 00:00:00,UK (London),74,134,5,213,,,54
2024-02-05 00:00:00,Uyo,73,94,7,174,,,55
2024-02-05 00:00:00,Dallas,25,21,1,47,,,56
2024-02-05 00:00:00,Abeokuta,118,202,8,328,7741,,57
2024-02-12 00:00:00,Lagos,2236,1476,171,3883,,,58
2024-02-12 00:00:00,Abuja,532,805,52,1389,,,59
2024-02-12 00:00:00,PHC,201,339,30,570,,,60
2024-02-12 00:00:00,Ibadan,278,486,38,802,,,61
2024-02-12 00:00:00,Ife,112,177,5,294,,,62
2024-02-12 00:00:00,Canada,118,188,20,326,,,63
2024-02-12 00:00:00,Uyo,80,106,2,188,,,64
2024-02-12 00:00:00,UK (Birm),54,89,2,145,,,65
2024-02-12 00:00:00,UK (London),73,145,3,221,,,66
2024-02-12 00:00:00,US - Dallas,21,23,0,44,,,67
2024-02-12 00:00:00,Abeokuta,69,128,7,204,8066,,68
2024-02-19 00:00:00,Lagos,1960,3024,128,5112,,,69
2024-02-19 00:00:00,Lagos (YAF),445,896,10,1351,,,70
2024-02-19 00:00:00,Abuja,477,742,64,1283,,,71
2024-02-19 00:00:00,PHC,197,251,43,491,,,72
2024-02-19 00:00:00,Ibadan,160,227,24,738,,,73
2024-02-19 00:00:00,Ife,99,158,19,276,,,74
2024-02-19 00:00:00,Canada,121,220,19,360,,,75
2024-02-19 00:00:00,UK (Birm),60,85,6,151,,,76
2024-02-19 00:00:00,UK (London),85,142,3,230,,,77
2024-02-19 00:00:00,Uyo,54,78,2,134,,,78
2024-02-19 00:00:00,Dallas,20,19,0,39,9013,,79
2024-02-19 00:00:00,Abeokuta,60,133,6,199,10364,,80
2024-02-26 00:00:00,Lagos - Ikeja,473,579,58,1110,,,81
2024-02-26 00:00:00,Lagos - Yaba,119,161,4,284,,,82
2024-02-26 00:00:00,Lagos - VI,110,142,10,262,1656,,83
2024-02-26 00:00:00,Abuja - Utako,248,248,41,537,,,86
2024-02-26 00:00:00,Abuja - Mararaba,82,104,9,195,,,87
2024-02-26 00:00:00,Abuja - Lokogoma,121,166,11,298,1030,,88
2024-02-26 00:00:00,PHC,124,206,19,349,,,89
2024-02-26 00:00:00,Canada,107,167,21,295,,,92
2024-02-26 00:00:00,UK (Birm),79,132,5,216,,,93
2024-02-26 00:00:00,UK (London),231,112,7,350,,,94
2024-02-26 00:00:00,Dallas,20,24,1,45,,,96
2024-03-05 00:00:00,Lagos - Ikeja,713,1137,131,1981,,,98
2024-03-05 00:00:00,Lagos - Yaba,214,339,11,564,,,99
2024-03-05 00:00:00,Lagos - VI,231,335,18,584,,,100
2024-03-05 00:00:00,Lagos - Ago,146,216,23,385,,,101
2024-03-05 00:00:00,Lagos - Ajah,103,104,15,222,,,102
2024-03-05 00:00:00,Abuja - Utako,264,369,35,668,,,103
2024-03-05 00:00:00,Abuja - Mararaba,98,124,8,230,,,104
2024-03-05 00:00:00,Abuja - Lokogoma,162,260,23,445,,,105
2024-03-05 00:00:00,PHC,173,299,36,508,,,106
2024-03-05 00:00:00,Ibadan,249,321,30,600,,,107
2024-03-05 00:00:00,Ife,101,88,5,194,,,108
2024-03-05 00:00:00,Canada,114,191,16,321,,,109
2024-03-05 00:00:00,UK (Birm),53,78,3,134,,,110
2024-03-05 00:00:00,UK (London),63,110,1,174,,,111
2024-03-05 00:00:00,Uyo,65,82,5,152,,,112
2024-03-05 00:00:00,Dallas,14,15,0,29,,,113
2024-03-05 00:00:00,Abeokuta,75,160,9,244,7435,,114
2024-03-12 00:00:00,Lagos - Ikeja,729,1035,126,1890,,,115
2024-03-12 00:00:00,Lagos - Yaba,246,348,14,608,,,116
2024-03-12 00:00:00,Lagos - VI,243,357,21,621,,,117
2024-03-12 00:00:00,Lagos - Ago,159,250,42,451,,,118
2024-03-12 00:00:00,Lagos - Ajah,108,116,19,243,Lagos : 3813,,119
2024-03-12 00:00:00,Abuja - Utako,304,443,40,787,,,120
2024-03-12 00:00:00,Abuja - Mararaba,95,125,13,233,,,121
2024-03-12 00:00:00,Abuja - Lokogoma,172,276,25,473,,,122
2024-03-12 00:00:00,PHC,203,275,39,517,,,123
2024-03-12 00:00:00,Ibadan,234,320,28,582,,,124
2024-03-12 00:00:00,Ife,105,125,3,233,,,125
2024-03-12 00:00:00,Canada,111,168,17,296,,,126
2024-03-12 00:00:00,UK (London),81,147,2,230,,,128
2024-03-12 00:00:00,Uyo,91,63,5,159,,,129
2024-03-12 00:00:00,Dallas,47,124,2,173,,,130
2024-03-12 00:00:00,Abeokuta,86,125,3,214,7710,,131
2024-03-19 00:00:00,Lagos - Ikeja,651,925,98,1674,,,132
2024-03-19 00:00:00,Lagos - Yaba,192,272,11,475,,,133
2024-03-19 00:00:00,Lagos - VI,215,274,18,507,,,134
2024-03-19 00:00:00,Lagos - Ajah,79,100,11,190,,,136
2024-03-19 00:00:00,Abuja - Utako,267,433,43,743,,,137
2024-03-19 00:00:00,Abuja - Mararaba,107,114,11,232,1165,,138
2024-03-19 00:00:00,Abuja - Lokogoma,170,253,24,447,,,139
2024-03-19 00:00:00,PHC,159,235,29,423,,,140
2024-03-19 00:00:00,Ibadan,228,294,23,545,,,141
2024-03-19 00:00:00,Ife,156,112,5,273,,,142
2024-03-19 00:00:00,Canada,121,163,21,305,,,143
2024-03-19 00:00:00,UK (Birm),40,62,2,104,,,144
2024-03-19 00:00:00,UK (London),84,91,2,177,,,145
2024-03-19 00:00:00,Dallas,14,20,0,34,,,147
2024-03-19 00:00:00,Abeokuta,93,138,3,234,6363,,148
2024-03-26 00:00:00,Lagos - Ikeja,665,922,54,1641,,,149
2024-03-26 00:00:00,Lagos - Yaba,337,505,19,861,,,150
2024-03-26 00:00:00,Lagos - VI,286,219,17,522,,,151
2024-03-26 00:00:00,Lagos - Ago,88,128,28,244,,,152
2024-03-26 00:00:00,Lagos - Ajah,88,128,7,223,,,153
2024-03-26 00:00:00,Abuja - Utako,273,367,24,664,,,154
2024-03-26 00:00:00,Abuja - Mararaba,93,116,17,226,,,155
2024-03-26 00:00:00,Abuja - Lokogoma,187,272,22,481,,,156
2024-03-26 00:00:00,PHC,168,275,27,470,,,157
2024-03-26 00:00:00,Ibadan,253,383,34,670,,,158
2024-03-26 00:00:00,Ife,152,220,8,380,,,159
2024-03-26 00:00:00,Canada,201,360,31,592,,Special Sunday Service ,160
2024-03-26 00:00:00,UK (Birm),41,49,3,93,,,161
2024-03-26 00:00:00,UK (London),49,92,4,145,,,162
2024-03-26 00:00:00,UK (Manchester),61,98,10,169,,,163
2024-03-26 00:00:00,Uyo,70,85,2,157,,,164
2024-03-26 00:00:00,Dallas,16,24,0,40,,,165
2024-03-26 00:00:00,Abeokuta,113,132,5,250,7828,,166
2024-04-02 00:00:00,Lagos - Ikeja,705,979,60,1744,,,167
2024-04-02 00:00:00,Lagos - Yaba,309,586,15,910,,,168
2024-04-02 00:00:00,Lagos - VI,360,325,16,701,,,169
2024-04-02 00:00:00,Lagos - Ago,133,221,35,389,,,170
2024-04-02 00:00:00,Abuja - Utako,262,387,44,693,,,172
2024-04-02 00:00:00,Abuja - Mararaba,93,120,12,225,,,173
2024-04-02 00:00:00,Abuja - Lokogoma,192,293,28,513,,,174
2024-04-02 00:00:00,PHC,340,243,38,621,,,175
2024-04-02 00:00:00,Ibadan,303,518,44,865,,,176
2024-04-02 00:00:00,Ife,169,264,1,434,,,177
2024-04-02 00:00:00,Canada,125,172,24,321,,,178
2024-04-02 00:00:00,UK (Birm),44,87,2,133,,,179
2024-04-02 00:00:00,UK (London),70,129,3,202,,,180
2024-04-02 00:00:00,UK (Manchester),36,49,6,91,,,181
2024-04-02 00:00:00,Uyo,71,99,5,175,,,182
2024-04-02 00:00:00,Dallas,21,27,0,48,,,183
2024-04-02 00:00:00,Abeokuta,92,150,7,249,8580,,184
2024-04-09 00:00:00,Lagos - Ikeja,683,856,28,1567,,,185
2024-04-09 00:00:00,Lagos - Yaba,303,515,8,826,,,186
2024-04-09 00:00:00,Lagos - VI,258,336,22,616,,,187
2024-04-09 00:00:00,Lagos - Ago,139,235,29,403,,,188
2024-04-09 00:00:00,Lagos - Ajah,110,134,13,257,,,189
2024-04-09 00:00:00,Abuja - Utako,274,384,49,707,,,190
2024-04-09 00:00:00,Abuja - Mararaba,93,120,12,225,,,191
2024-04-09 00:00:00,Abuja - Lokogoma,192,293,28,513,,,192
2024-04-09 00:00:00,PHC,222,338,41,601,,,193
2024-04-09 00:00:00,Ibadan,327,487,42,856,,,194
2024-04-09 00:00:00,Ife,140,211,6,357,,,195
2024-04-09 00:00:00,Canada,147,245,24,416,,Special Sunday service ,196
2024-04-09 00:00:00,UK (Birm),83,43,5,131,,,197
2024-04-09 00:00:00,UK (London),78,141,6,225,,,198
2024-04-09 00:00:00,UK (Manchester),39,48,6,93,,,199
2024-04-09 00:00:00,Uyo,71,101,4,176,,,200
2024-04-09 00:00:00,Dallas,27,32,1,60,,,201
2024-04-09 00:00:00,Abeokuta,75,104,2,181,8210,,202
2024-04-16 00:00:00,Lagos - Ikeja,674,903,80,1657,,,203
2024-04-16 00:00:00,Lagos - Yaba,270,535,10,815,,,204
2024-04-16 00:00:00,Lagos - VI,223,279,20,522,,,205
2024-04-16 00:00:00,Lagos - Ago,146,240,32,418,,,206
2024-04-16 00:00:00,Lagos - Ajah,123,144,9,276,,,207
2024-04-16 00:00:00,Abuja - Utako,227,397,36,660,,,208
2024-04-16 00:00:00,Abuja - Mararaba,77,109,12,198,,,209
2024-04-16 00:00:00,Abuja - Lokogoma,173,256,24,453,,,210
2024-04-16 00:00:00,PHC,207,331,40,578,,,211
2024-04-16 00:00:00,Ibadan,299,482,51,832,,,212
2024-04-16 00:00:00,Ife,115,221,3,339,,,213
2024-04-16 00:00:00,Canada,127,183,24,334,,,214
2024-04-16 00:00:00,UK (Birm),42,66,6,114,,,215
2024-04-16 00:00:00,UK (London) S1,141,244,18,403,,,216
2024-04-16 00:00:00,UK (London) S2,109,206,12,327,,,217
2024-04-16 00:00:00,UK (Manchester),29,52,5,86,,,218
2024-04-16 00:00:00,Uyo,98,106,1,205,,,219
2024-04-16 00:00:00,Dallas,17,24,1,42,,,220
2024-04-16 00:00:00,Abeokuta,68,114,10,192,8451,,221
2024-04-23 00:00:00,Lagos - Ikeja,594,848,69,1511,,,222
2024-04-23 00:00:00,Lagos - Yaba,280,489,19,788,,,223
2024-04-23 00:00:00,Lagos - VI,204,264,9,477,,,224
2024-04-23 00:00:00,Lagos - Ago,122,211,37,370,,,225
2024-04-23 00:00:00,Lagos - Ajah,98,115,11,224,,,226
2024-04-23 00:00:00,Abuja - Utako,276,360,33,669,,,227
2024-04-23 00:00:00,Abuja - Mararaba,78,121,14,213,,,228
2024-04-23 00:00:00,Abuja - Lokogoma,181,293,36,510,,,229
2024-04-23 00:00:00,PHC,222,286,30,538,,,230
2024-04-23 00:00:00,Ibadan,305,441,53,799,,,231
2024-04-23 00:00:00,Ife,116,196,3,315,,,232
2024-04-23 00:00:00,Canada,111,185,28,324,,,233
2024-04-23 00:00:00,UK (Birm),237,433,30,700,,,234
2024-04-23 00:00:00,Uyo,89,118,5,212,,,237
2024-04-23 00:00:00,Abeokuta,62,122,5,189,7890,,239
2024-04-30 00:00:00,Lagos - Ikeja,645,969,82,1696,,,240
2024-04-30 00:00:00,Lagos - Yaba,305,499,17,821,,,241
2024-04-30 00:00:00,Lagos - VI,221,269,20,510,,,242
2024-04-30 00:00:00,Lagos - Ago,143,248,26,417,,,243
2024-04-30 00:00:00,Lagos - Ajah,90,126,8,224,,,244
2024-04-30 00:00:00,Abuja - Utako,246,347,48,641,,,245
2024-04-30 00:00:00,Abuja - Mararaba,87,153,22,262,,,246
2024-04-30 00:00:00,Abuja - Lokogoma,170,290,30,490,,,247
2024-04-30 00:00:00,PHC,204,313,29,546,,,248
2024-04-30 00:00:00,Ibadan,317,460,31,808,,,249
2024-04-30 00:00:00,Ife,130,207,1,338,,,250
2024-04-30 00:00:00,Canada,118,187,18,323,,,251
2024-04-30 00:00:00,UK (Birm),46,73,8,127,,,252
2024-04-30 00:00:00,UK (London),74,120,3,197,,,253
2024-04-30 00:00:00,UK (Manchester),29,47,6,82,,,254
2024-04-30 00:00:00,Uyo,77,96,8,181,,,255
2024-04-30 00:00:00,Dallas,19,29,1,49,,,256
2024-04-30 00:00:00,Abeokuta,76,116,9,201,7913,,257
2024-05-07 00:00:00,Lagos - Ikeja,727,978,119,1824,,,258
2024-05-07 00:00:00,Lagos - Yaba,411,724,25,1160,,,259
2024-05-07 00:00:00,Lagos - VI,227,331,21,579,,,260
2024-05-07 00:00:00,Lagos - Ago,166,267,36,469,,,261
2024-05-07 00:00:00,Lagos - Ajah,106,149,8,263,4295,,262
2024-05-07 00:00:00,Abuja - Utako,270,350,28,648,,,263
2024-05-07 00:00:00,Abuja - Mararaba,81,130,15,226,,,264
2024-05-07 00:00:00,Abuja - Lokogoma,178,276,30,484,1358,,265
2024-05-07 00:00:00,PHC,377,255,26,658,,,266
2024-05-07 00:00:00,Ibadan,344,458,50,852,,,267
2024-05-07 00:00:00,Ife,116,191,3,310,,,268
2024-05-07 00:00:00,Canada,134,186,21,341,,,269
2024-05-07 00:00:00,UK (Birm),50,73,7,130,,,270
2024-05-07 00:00:00,UK (London),61,146,5,212,,,271
2024-05-07 00:00:00,UK (Manchester),36,55,5,96,,,272
2024-05-07 00:00:00,Uyo,93,114,5,212,,,273
2024-05-07 00:00:00,Dallas,17,30,1,48,,,274
2024-05-07 00:00:00,Abeokuta,85,143,6,234,8746,,275
2024-05-14 00:00:00,Lagos - Ikeja,924,843,95,1862,,1767,276
2024-05-14 00:00:00,Lagos - Yaba,365,582,24,971,,,277
2024-05-14 00:00:00,Lagos - VI,223,324,35,582,,,278
2024-05-14 00:00:00,Lagos - Ago,231,150,32,413,,,279
2024-05-14 00:00:00,Lagos - Ajah,109,163,11,283,4111,,280
2024-05-14 00:00:00,Abuja - Utako,294,389,31,714,,,281
2024-05-14 00:00:00,Abuja - Mararaba,95,114,22,231,,,282
2024-05-14 00:00:00,Abuja - Lokogoma,188,279,31,498,,,283
2024-05-14 00:00:00,PHC,240,308,31,579,,,284
2024-05-14 00:00:00,Ibadan,348,471,44,863,,,285
2024-05-14 00:00:00,Ife,129,217,3,349,,,286
2024-05-14 00:00:00,Canada,131,199,23,353,,,287
2024-05-14 00:00:00,UK (Birm),52,90,9,151,,,288
2024-05-14 00:00:00,UK (London),69,144,9,222,,,289
2024-05-14 00:00:00,UK(Manchester),39,59,5,103,,,290
2024-05-14 00:00:00,Uyo,82,94,6,182,,,291
2024-05-14 00:00:00,Dallas,22,28,2,52,,,292
2024-05-14 00:00:00,Abeokuta,63,164,10,237,8645,,293
2024-05-21 00:00:00,Lagos - Ikeja,719,1055,77,1851,,,294
2024-05-21 00:00:00,Lagos - Yaba,368,588,19,975,,,295
2024-05-21 00:00:00,Lagos - VI,193,282,18,493,,,296
2024-05-21 00:00:00,Lagos - Ago,173,247,46,466,,,297
2024-05-21 00:00:00,Lagos - Ajah,132,126,19,277,,,298
2024-05-21 00:00:00,Abuja - Utako,295,415,45,755,,,299
2024-05-21 00:00:00,Abuja - Mararaba,106,142,11,259,,,300
2024-05-21 00:00:00,Abuja - Lokogoma,157,281,26,464,,,301
2024-05-21 00:00:00,PHC,226,343,32,601,,,302
2024-05-21 00:00:00,Ibadan,270,443,38,751,,,303
2024-05-21 00:00:00,Ife,121,221,3,345,,,304
2024-05-21 00:00:00,Canada,126,214,22,362,,,305
2024-05-21 00:00:00,UK (Birm),92,55,6,153,,,306
2024-05-21 00:00:00,UK (London),93,131,8,232,,,307
2024-05-21 00:00:00,UK (Manchester),33,58,6,97,482,,308
2024-05-21 00:00:00,Uyo,87,129,9,225,,,309
2024-05-21 00:00:00,Dallas,22,23,0,45,,,310
2024-05-21 00:00:00,Abeokuta,62,156,12,230,8581,,311
2024-05-28 00:00:00,Lagos - Ikeja,720,1048,67,1835,,,312
2024-05-28 00:00:00,Lagos - Yaba,327,476,27,830,,,313
2024-05-28 00:00:00,Lagos - VI,196,290,23,509,,,314
2024-05-28 00:00:00,Lagos - Ago,174,250,49,473,,,315
2024-05-28 00:00:00,Lagos - Ajah,123,149,20,292,,,316
2024-05-28 00:00:00,Abuja - Utako,295,415,45,755,,,317
2024-05-28 00:00:00,Abuja - Mararaba,106,142,11,259,,,318
2024-05-28 00:00:00,Abuja - Lokogoma,157,281,26,464,,,319
2024-05-28 00:00:00,PHC,230,292,37,559,,,320
2024-05-28 00:00:00,Ibadan,223,392,40,655,,,321
2024-05-28 00:00:00,Ife,138,191,4,333,,,322
2024-05-28 00:00:00,Canada,108,167,19,294,,,323
2024-05-28 00:00:00,UK (Birm),50,94,7,151,,,324
2024-05-28 00:00:00,UK (London),77,143,18,238,,,325
2024-05-28 00:00:00,UK (Glasglow),55,43,2,100,,,326
2024-05-28 00:00:00,UK (Manchester),39,57,7,103,,,327
2024-05-28 00:00:00,Uyo,100,129,14,243,,,328
2024-05-28 00:00:00,Dallas,28,32,0,60,,,329
2024-05-28 00:00:00,Abeokuta,64,115,15,194,8347,,330
2024-06-04 00:00:00,Lagos - Ikeja,755,1036,88,1879,,,331
2024-06-04 00:00:00,Lagos - Yaba,328,604,14,946,,,332
2024-06-04 00:00:00,Lagos - VI,195,287,23,505,,,333
2024-06-04 00:00:00,Lagos - Ago,169,246,52,467,,,334
2024-06-04 00:00:00,Lagos - Ajah,132,148,13,293,,,335
2024-06-04 00:00:00,Abuja - Utako,281,367,39,687,,,336
2024-06-04 00:00:00,Abuja - Mararaba,93,139,36,268,,,337
2024-06-04 00:00:00,Abuja - Lokogoma,167,292,22,481,,,338
2024-06-04 00:00:00,PHC,230,370,35,635,,,339
2024-06-04 00:00:00,Ibadan,312,480,40,832,,,340
2024-06-04 00:00:00,Ife,122,194,2,318,,,341
2024-06-04 00:00:00,Canada,127,200,24,351,,,342
2024-06-04 00:00:00,UK (Birm),52,100,6,158,,,343
2024-06-04 00:00:00,UK (London),84,138,5,227,,,344
2024-06-04 00:00:00,UK (Glasglow),27,22,1,50,,,345
2024-06-04 00:00:00,UK (Manchester),36,56,8,100,,,346
2024-06-04 00:00:00,Uyo,94,130,9,233,,,347
2024-06-04 00:00:00,Dallas,23,29,1,53,,,348
2024-06-04 00:00:00,Abeokuta,72,127,10,209,8692,,349
2024-06-11 00:00:00,Lagos - Ikeja,737,1000,78,1815,,,350
2024-06-11 00:00:00,Lagos - Yaba,283,505,19,807,,,351
2024-06-11 00:00:00,Lagos - VI,159,285,19,463,,,352
2024-06-11 00:00:00,Lagos - Ago,174,268,36,478,,,353
2024-06-11 00:00:00,Lagos - Ajah,129,159,20,308,,,354
2024-06-11 00:00:00,Abuja - Utako,212,283,31,526,,,355
2024-06-11 00:00:00,Abuja - Mararaba,69,78,25,172,,,356
2024-06-11 00:00:00,Abuja - Lokogoma,124,199,29,352,,,357
2024-06-11 00:00:00,PHC,230,336,14,580,,,358
2024-06-11 00:00:00,Ibadan,260,464,43,767,,,359
2024-06-11 00:00:00,Ife,128,230,2,360,,,360
2024-06-11 00:00:00,Canada,131,185,21,337,,,361
2024-06-11 00:00:00,UK (Birm),63,106,21,190,,,362
2024-06-11 00:00:00,UK (London),87,144,6,237,,,363
2024-06-11 00:00:00,UK (Glasglow),21,22,1,44,,,364
2024-06-11 00:00:00,UK (Manchester),38,56,4,98,,,365
2024-06-11 00:00:00,Uyo,91,109,5,205,,,366
2024-06-11 00:00:00,Dallas,26,30,3,59,,,367
2024-06-11 00:00:00,Abeokuta,47,98,10,155,7953,,368
2024-06-18 00:00:00,Lagos - Ikeja,733,908,96,1737,,,369
2024-06-18 00:00:00,Lagos - Yaba,349,546,19,914,,,370
2024-06-18 00:00:00,Lagos - VI,186,280,26,492,,,371
2024-06-18 00:00:00,Lagos - Ago,175,276,5,456,,,372
2024-06-18 00:00:00,Lagos - Ajah,145,162,9,316,,,373
2024-06-18 00:00:00,Abuja - Utako,284,415,44,743,,,374
2024-06-18 00:00:00,Abuja - Mararaba,90,121,17,228,,,375
2024-06-18 00:00:00,Abuja - Lokogoma,176,276,23,475,,,376
2024-06-18 00:00:00,PHC,201,303,34,538,,,377
2024-06-18 00:00:00,Ibadan,286,452,51,789,,,378
2024-06-18 00:00:00,Ife,124,148,4,276,,,379
2024-06-18 00:00:00,Canada,141,201,23,365,,,380
2024-06-18 00:00:00,UK (Birm),59,91,6,156,,,381
2024-06-18 00:00:00,UK (London),76,144,7,227,,,382
2024-06-18 00:00:00,UK (Glasglow),22,28,2,52,,,383
2024-06-18 00:00:00,UK (Manchester),36,55,4,95,,,384
2024-06-18 00:00:00,Uyo,99,123,8,230,,,385
2024-06-18 00:00:00,Dallas,31,34,3,68,,,386
2024-06-18 00:00:00,Abeokuta,67,97,6,170,8327,,387
2024-06-25 00:00:00,Lagos - Ikeja,648,948,68,1664,,,388
2024-06-25 00:00:00,Lagos - Yaba,292,443,11,746,,,389
2024-06-25 00:00:00,Lagos - VI,211,330,30,571,,,390
2024-06-25 00:00:00,Lagos - Ago,180,285,37,502,,,391
2024-06-25 00:00:00,Lagos - Ajah,198,252,21,471,,,392
2024-06-25 00:00:00,Abuja - Utako,293,370,36,699,,,393
2024-06-25 00:00:00,Abuja - Mararaba,92,144,25,261,,,394
2024-06-25 00:00:00,Abuja - Lokogoma,158,278,29,465,,,395
2024-06-25 00:00:00,PHC,230,373,41,644,,,396
2024-06-25 00:00:00,Ibadan,262,380,47,689,,,397
2024-06-25 00:00:00,Ife,98,172,12,282,,,398
2024-06-25 00:00:00,Canada,124,230,32,386,,,399
2024-06-25 00:00:00,UK (Birm),50,84,7,141,,,400
2024-06-25 00:00:00,UK (London),70,145,4,219,,,401
2024-06-25 00:00:00,UK (Glasglow),23,28,2,53,,,402
2024-06-25 00:00:00,UK (Manchester),52,67,3,122,,,403
2024-06-25 00:00:00,Uyo,110,132,9,251,,,404
2024-06-25 00:00:00,Abeokuta,69,121,11,201,8416,,406
2024-07-02 00:00:00,Lagos - Ikeja,723,1058,87,1868,,,407
2024-07-02 00:00:00,Lagos - Yaba,261,399,20,680,,,408
2024-07-02 00:00:00,Lagos - VI,184,263,15,462,,,409
2024-07-02 00:00:00,Lagos - Ago,210,316,43,569,,,410
2024-07-02 00:00:00,Lagos - Ajah,155,167,18,340,,,411
2024-07-02 00:00:00,Abuja - Utako,278,412,36,726,,,412
2024-07-02 00:00:00,Abuja - Mararaba,86,109,14,209,,,413
2024-07-02 00:00:00,Abuja - Lokogoma,182,299,45,526,,,414
2024-07-02 00:00:00,PHC,206,318,37,561,,,415
2024-07-02 00:00:00,Ibadan,295,400,35,730,,,416
2024-07-02 00:00:00,Ife,119,187,5,311,,,417
2024-07-02 00:00:00,Canada (Toronto),133,191,27,351,,,418
2024-07-02 00:00:00,Canada (Ottawa),20,40,2,62,,,419
2024-07-02 00:00:00,UK (Birm),45,77,4,126,,,420
2024-07-02 00:00:00,UK (London),81,157,3,241,,,421
2024-07-02 00:00:00,UK (Glasglow),24,22,1,47,,,422
2024-07-02 00:00:00,UK (Manchester),47,70,10,127,,,423
2024-07-02 00:00:00,Uyo,210,315,9,534,,,424
2024-07-02 00:00:00,Dallas,24,30,0,54,,,425
2024-07-02 00:00:00,Abeokuta,85,108,11,204,8728,,426
2024-07-09 00:00:00,Lagos - Ikeja,683,883,72,1638,,,427
2024-07-09 00:00:00,Lagos - Yaba,159,258,10,427,,,428
2024-07-09 00:00:00,Lagos - VI,157,238,13,408,,,429
2024-07-09 00:00:00,Lagos - Ago,125,215,24,364,,,430
2024-07-09 00:00:00,Lagos - Ajah,91,124,15,230,,,431
2024-07-09 00:00:00,Abuja - Utako,275,352,29,656,,,432
2024-07-09 00:00:00,Abuja - Mararaba,82,124,24,230,,,433
2024-07-09 00:00:00,Abuja - Lokogoma,192,279,26,497,,,434
2024-07-09 00:00:00,PHC,219,360,23,602,,,435
2024-07-09 00:00:00,Ibadan,304,452,31,787,,,436
2024-07-09 00:00:00,Ife,154,180,4,338,,,437
2024-07-09 00:00:00,Canada (Toronto),143,218,35,396,,,438
2024-07-09 00:00:00,UK (Birm),59,83,6,148,,,440
2024-07-09 00:00:00,UK (London),142,71,8,221,,,441
2024-07-09 00:00:00,UK (Glasglow),31,24,1,56,,,442
2024-07-09 00:00:00,UK (Manchester),50,89,8,147,,,443
2024-07-09 00:00:00,Uyo,141,216,3,360,,,444
2024-07-09 00:00:00,Dallas,19,31,1,51,,,445
2024-07-09 00:00:00,Abeokuta,67,113,7,187,7768,,446
2024-07-16 00:00:00,Lagos - Ikeja,717,1132,68,1917,,,447
2024-07-16 00:00:00,Lagos - Yaba,271,452,20,743,,,448
2024-07-16 00:00:00,Lagos - VI,209,287,22,518,,,449
2024-07-16 00:00:00,Lagos - Ago,193,323,49,565,,,450
2024-07-16 00:00:00,Lagos - Ajah,129,175,13,317,,,451
2024-07-16 00:00:00,Abuja - Utako,300,356,52,708,,,452
2024-07-16 00:00:00,Abuja - Mararaba,79,124,16,219,,,453
2024-07-16 00:00:00,Abuja - Lokogoma,159,270,30,459,,,454
2024-07-16 00:00:00,PHC,220,360,23,603,,,455
2024-07-16 00:00:00,Ibadan,291,444,49,784,,,456
2024-07-16 00:00:00,Ife,125,168,3,296,,,457
2024-07-16 00:00:00,Canada (Toronto),118,177,29,324,,,458
2024-07-16 00:00:00,Canada (Ottawa),19,18,4,41,,,459
2024-07-16 00:00:00,UK (Birm),52,80,12,144,,,460
2024-07-16 00:00:00,UK (London),78,149,5,232,,,461
2024-07-16 00:00:00,UK (Glasglow),22,27,1,50,,,462
2024-07-16 00:00:00,UK (Manchester),43,61,5,109,,,463
2024-07-16 00:00:00,Uyo,138,226,14,378,,,464
2024-07-16 00:00:00,Akure,85,107,4,196,,,465
2024-07-16 00:00:00,Dallas,21,29,1,51,,,466
2024-07-16 00:00:00,Abeokuta,86,106,8,200,8854,,467
2024-07-23 00:00:00,Lagos - Ikeja,635,880,67,1582,,,468
2024-07-23 00:00:00,Lagos - Yaba,260,380,18,658,,,469
2024-07-23 00:00:00,Lagos - VI,172,235,11,418,,,470
2024-07-23 00:00:00,Lagos - Ago,150,240,24,414,,,471
2024-07-23 00:00:00,Lagos - Ajah,128,157,16,301,,,472
2024-07-23 00:00:00,Abuja - Utako,280,344,41,665,,,473
2024-07-23 00:00:00,Abuja - Mararaba,93,119,19,231,,,474
2024-07-23 00:00:00,Abuja - Lokogoma,167,286,33,486,,,475
2024-07-23 00:00:00,PHC,220,341,43,604,,,476
2024-07-23 00:00:00,Ibadan,298,469,43,810,,,477
2024-07-23 00:00:00,Ife,115,155,6,276,,,478
2024-07-23 00:00:00,Canada (Toronto),130,214,27,371,,,479
2024-07-23 00:00:00,Canada (Ottawa),13,25,2,40,,,480
2024-07-23 00:00:00,UK (Birm),48,90,12,150,,,481
2024-07-23 00:00:00,UK (London),74,142,4,220,,,482
2024-07-23 00:00:00,UK (Glasglow),26,23,1,50,,,483
2024-07-23 00:00:00,UK (Manchester),47,63,4,114,,,484
2024-07-23 00:00:00,Uyo,179,192,11,382,,,485
2024-07-23 00:00:00,Akure,63,51,2,116,,,486
2024-07-23 00:00:00,Dallas,37,103,8,148,,,487
2024-07-23 00:00:00,Abeokuta,64,111,10,185,8221,,488
2024-07-30 00:00:00,Lagos - Ikeja,746,1001,89,1836,,,489
2024-07-30 00:00:00,Lagos - Yaba,288,417,19,724,,,490
2024-07-30 00:00:00,Lagos - VI,167,273,15,455,,,491
2024-07-30 00:00:00,Lagos - Ago,179,278,40,497,,,492
2024-07-30 00:00:00,Lagos - Ajah,108,122,21,251,,,493
2024-07-30 00:00:00,Abuja - Utako,289,412,38,739,,,494
2024-07-30 00:00:00,Abuja - Mararaba,100,115,15,230,,,495
2024-07-30 00:00:00,Abuja - Lokogoma,191,281,34,506,,,496
2024-07-30 00:00:00,PHC,247,340,23,610,,,497
2024-07-30 00:00:00,Ibadan,276,421,44,741,,,498
2024-07-30 00:00:00,Ife,92,163,2,257,,,499
2024-07-30 00:00:00,Canada (Toronto),139,212,34,385,,,500
2024-07-30 00:00:00,Canada (Ottawa),11,28,2,41,,,501
2024-07-30 00:00:00,UK (London),277,435,11,723,,,503
2024-07-30 00:00:00,Uyo,148,201,9,358,,,506
2024-07-30 00:00:00,Akure,45,49,3,97,,,507
2024-07-30 00:00:00,Dallas,22,31,0,53,,,508
2024-07-30 00:00:00,Abeokuta,70,105,5,180,8683,,509
2024-08-06 00:00:00,Lagos - Ikeja,821,1115,66,2002,,,510
2024-08-06 00:00:00,Lagos - Yaba,380,475,21,876,,,511
2024-08-06 00:00:00,Lagos - VI,229,342,21,592,,,512
2024-08-06 00:00:00,Lagos - Ago,245,298,41,584,,,513
2024-08-06 00:00:00,Lagos - Ajah,126,164,23,313,,,514
2024-08-06 00:00:00,Abuja - Utako,334,410,58,802,,,515
2024-08-06 00:00:00,Abuja - Mararaba,102,128,27,257,,,516
2024-08-06 00:00:00,Abuja - Lokogoma,195,307,43,545,,,517
2024-08-06 00:00:00,PHC,223,333,50,606,,,518
2024-08-06 00:00:00,Ibadan,340,531,42,913,,,519
2024-08-06 00:00:00,Ife,124,153,6,283,,,520
2024-08-06 00:00:00,Canada (Toronto),122,211,33,366,,,521
2024-08-06 00:00:00,Canada (Ottawa),19,27,4,50,,,522
2024-08-06 00:00:00,UK (Birm),50,87,9,146,,,523
2024-08-06 00:00:00,UK (London),96,157,9,262,,,524
2024-08-06 00:00:00,UK (Glasglow),19,28,2,49,,,525
2024-08-06 00:00:00,UK (Manchester),61,98,14,173,,,526
2024-08-06 00:00:00,Uyo,72,103,2,177,,,527
2024-08-06 00:00:00,Akure,38,64,2,104,,,528
2024-08-06 00:00:00,Dallas,21,37,1,59,,,529
2024-08-06 00:00:00,Abeokuta,76,141,8,225,9384,,530
2024-08-13 00:00:00,Lagos - Ikeja,751,1032,84,1867,,,531
2024-08-13 00:00:00,Lagos - Yaba,358,566,19,943,,,532
2024-08-13 00:00:00,Lagos - VI,184,291,19,494,,,533
2024-08-13 00:00:00,Lagos - Ago,203,306,38,547,,,534
2024-08-13 00:00:00,Lagos - Ajah,126,177,24,327,,,535
2024-08-13 00:00:00,Abuja - Utako,257,368,46,671,,,536
2024-08-13 00:00:00,Abuja - Mararaba,80,131,24,235,,,537
2024-08-13 00:00:00,Abuja - Lokogoma,174,287,53,514,,,538
2024-08-13 00:00:00,PHC,501,800,36,1337,,,539
2024-08-13 00:00:00,Ibadan,281,428,29,738,,,540
2024-08-13 00:00:00,Ife,112,173,3,288,,,541
2024-08-13 00:00:00,Canada (Toronto),152,232,27,411,,,542
2024-08-13 00:00:00,Canada (Ottawa),11,15,2,28,,,543
2024-08-13 00:00:00,UK (Birm),66,89,10,165,,,544
2024-08-13 00:00:00,UK (London),78,136,5,219,,,545
2024-08-13 00:00:00,UK (Glasglow),26,22,1,49,,,546
2024-08-13 00:00:00,UK (Manchester),52,67,7,126,,,547
2024-08-13 00:00:00,Uyo,96,134,5,235,,,548
2024-08-13 00:00:00,Dallas,16,38,1,55,,,550
2024-08-13 00:00:00,Abeokuta,63,106,2,171,,,551
2024-08-13 00:00:00,Ilorin,414,0,2,416,9951,,552
2024-08-20 00:00:00,Lagos - Ikeja,747,1046,76,1869,,,553
2024-08-20 00:00:00,Lagos - Yaba,323,469,16,808,,,554
2024-08-20 00:00:00,Lagos - VI,192,302,26,520,,,555
2024-08-20 00:00:00,Lagos - Ago,217,300,41,558,,,556
2024-08-20 00:00:00,Lagos - Ajah,135,177,28,340,,,557
2024-08-20 00:00:00,Abuja - Utako,225,334,54,613,,,558
2024-08-20 00:00:00,Abuja - Mararaba,96,118,30,244,,,559
2024-08-20 00:00:00,Abuja - Lokogoma,182,262,38,482,,,560
2024-08-20 00:00:00,PHC,261,346,34,641,,,561
2024-08-20 00:00:00,Ibadan,269,422,47,738,,,562
2024-08-20 00:00:00,Ife,127,174,6,307,,,563
2024-08-20 00:00:00,Canada (Toronto),141,236,28,405,,,564
2024-08-20 00:00:00,Canada (Ottawa),16,27,3,46,,,565
2024-08-20 00:00:00,UK (Birm),60,86,7,153,,,566
2024-08-20 00:00:00,UK (London),89,138,9,236,,,567
2024-08-20 00:00:00,UK (Glasglow),30,30,1,61,,,568
2024-08-20 00:00:00,UK (Manchester),71,77,10,158,,,569
2024-08-20 00:00:00,Uyo,90,124,8,222,,,570
2024-08-20 00:00:00,Akure,50,57,6,113,,,571
2024-08-20 00:00:00,Dallas,18,28,1,47,,,572
2024-08-20 00:00:00,Ilorin,129,74,2,205,,,573
2024-08-20 00:00:00,Abeokuta,72,104,7,183,8949,,574
2024-08-27 00:00:00,Lagos - Ikeja,769,1115,85,1969,,,575
2024-08-27 00:00:00,Lagos - Yaba,367,410,17,794,,,576
2024-08-27 00:00:00,Lagos - VI,177,268,23,468,,,577
2024-08-27 00:00:00,Lagos - Ago,179,286,42,507,,,578
2024-08-27 00:00:00,Lagos - Ajah,121,169,33,323,,,579
2024-08-27 00:00:00,Abuja - Utako,223,327,51,601,,,580
2024-08-27 00:00:00,Abuja - Mararaba,78,103,13,194,,,581
2024-08-27 00:00:00,Abuja - Lokogoma,134,215,41,390,,,582
2024-08-27 00:00:00,PHC,223,338,40,601,,,583
2024-08-27 00:00:00,Ibadan,283,424,48,755,,,584
2024-08-27 00:00:00,Ife,138,176,4,318,,,585
2024-08-27 00:00:00,Canada (Toronto),139,209,28,376,,,586
2024-08-27 00:00:00,Canada (Ottawa),14,23,6,43,,,587
2024-08-27 00:00:00,UK (Birm),53,97,10,160,,,588
2024-08-27 00:00:00,UK (London),91,170,16,277,,,589
2024-08-27 00:00:00,UK (Glasglow),23,23,1,47,,,590
2024-08-27 00:00:00,UK (Manchester),58,81,3,142,,,591
2024-08-27 00:00:00,Uyo,104,142,10,256,,,592
2024-08-27 00:00:00,Akure,50,57,3,110,,,593
2024-08-27 00:00:00,Ilorin,69,103,1,173,,,594
2024-08-27 00:00:00,Abeokuta,64,111,6,181,,,596
2024-08-27 00:00:00,Benin,81,129,16,226,8965,,597
2024-09-03 00:00:00,Lagos - Ikeja,783,1146,68,1997,,,598
2024-09-03 00:00:00,Lagos - Yaba,250,483,17,750,,,599
2024-09-03 00:00:00,Lagos - VI,169,256,22,447,,,600
2024-09-03 00:00:00,Lagos - Ago,162,319,51,532,,,601
2024-09-03 00:00:00,Lagos - Ajah,146,174,22,342,,,602
2024-09-03 00:00:00,Abuja - Utako,288,386,52,726,,,603
2024-09-03 00:00:00,Abuja - Mararaba,107,152,32,291,,,604
2024-09-03 00:00:00,Abuja - Lokogoma,198,299,41,538,,,605
2024-09-03 00:00:00,PHC,224,360,38,622,,,606
2024-09-03 00:00:00,Ibadan,318,450,54,822,,,607
2024-09-03 00:00:00,Ife,127,194,7,328,,,608
2024-09-03 00:00:00,Canada (Toronto),125,193,22,340,,,609
2024-09-03 00:00:00,Canada (Ottawa),12,22,1,35,,,610
2024-09-03 00:00:00,UK (Birm),53,91,9,153,,,611
2024-09-03 00:00:00,UK (London),164,82,10,256,,,612
2024-09-03 00:00:00,UK (Glasglow),26,32,0,58,,,613
2024-09-03 00:00:00,UK (Manchester),64,93,6,163,,,614
2024-09-03 00:00:00,Uyo,103,123,7,233,,,615
2024-09-03 00:00:00,Akure,45,66,1,112,,,616
2024-09-03 00:00:00,US - Dallas,14,25,2,41,,,617
2024-09-03 00:00:00,US - DMV,23,57,2,82,,,618
2024-09-03 00:00:00,Ilorin,68,99,1,168,,,619
2024-09-03 00:00:00,Abeokuta,85,134,5,224,,,620
2024-09-03 00:00:00,Benin,58,85,4,147,9407,,621
2024-09-10 00:00:00,Lagos - Ikeja,717,1030,69,1816,,,622
2024-09-10 00:00:00,Lagos - Yaba,529,398,17,944,,,623
2024-09-10 00:00:00,Lagos - VI,234,363,11,608,,,624
2024-09-10 00:00:00,Lagos - Ago,184,315,50,549,,,625
2024-09-10 00:00:00,Lagos - Ajah,139,166,20,325,,,626
2024-09-10 00:00:00,Abuja - Utako,309,423,63,795,,,627
2024-09-10 00:00:00,Abuja - Mararaba,111,133,24,268,,,628
2024-09-10 00:00:00,Abuja - Lokogoma,202,317,35,554,,,629
2024-09-10 00:00:00,PHC,255,419,37,711,,,630
2024-09-10 00:00:00,Ibadan,329,487,52,868,,,631
2024-09-10 00:00:00,Ife,115,179,6,300,,,632
2024-09-10 00:00:00,Canada (Toronto),147,226,28,401,,,633
2024-09-10 00:00:00,Canada (Ottawa),18,32,5,55,,,634
2024-09-10 00:00:00,UK (Birm),55,100,8,163,,,635
2024-09-10 00:00:00,UK (London),83,158,9,250,,,636
2024-09-10 00:00:00,UK (Manchester),59,84,9,152,,,638
2024-09-10 00:00:00,Uyo,108,126,5,239,,,639
2024-09-10 00:00:00,Akure,52,71,8,131,,,640
2024-09-10 00:00:00,US-Dallas,19,32,0,51,,,641
2024-09-10 00:00:00,US-DMV,11,22,0,33,,,642
2024-09-10 00:00:00,Benin,47,68,0,115,,,643
2024-09-10 00:00:00,Ilorin,64,111,2,177,,,644
2024-09-10 00:00:00,Abeokuta,82,111,6,199,9704,,645
2024-09-17 00:00:00,Lagos - Ikeja,761,1090,66,1917,,,646
2024-09-17 00:00:00,Lagos - Yaba,345,515,10,870,,,647
2024-09-17 00:00:00,Lagos - VI,178,326,10,514,,,648
2024-09-17 00:00:00,Lagos - Ago,216,296,38,550,,,649
2024-09-17 00:00:00,Lagos - Ajah,121,170,18,309,,,650
2024-09-17 00:00:00,Abuja - Utako,278,396,44,718,,,651
2024-09-17 00:00:00,Abuja - Mararaba,145,163,26,334,,,652
2024-09-17 00:00:00,Abuja - Lokogoma,206,325,37,568,,,653
2024-09-17 00:00:00,PHC,281,379,43,703,,,654
2024-09-17 00:00:00,Ibadan,305,481,50,836,,,655
2024-09-17 00:00:00,Ife,107,166,7,280,,,656
2024-09-17 00:00:00,Canada (Toronto),147,233,25,405,,,657
2024-09-17 00:00:00,Canada (Ottawa),20,37,8,65,,,658
2024-09-17 00:00:00,UK (Birm),68,95,7,170,,,659
2024-09-17 00:00:00,UK (London),91,160,6,257,,,660
2024-09-17 00:00:00,UK (Glasglow),34,35,1,70,,,661
2024-09-17 00:00:00,UK (Manchester),52,92,10,154,,,662
2024-09-17 00:00:00,Uyo,98,105,8,211,,,663
2024-09-17 00:00:00,Akure,60,78,8,146,,,664
2024-09-17 00:00:00,US-Dallas,19,29,1,49,,,665
2024-09-17 00:00:00,US-DMV,11,26,0,37,,,666
2024-09-17 00:00:00,Ilorin,61,84,5,150,,,667
2024-09-17 00:00:00,Abeokuta,79,133,10,222,,,668
2024-09-17 00:00:00,Benin,34,64,3,101,9636,,669
2024-09-24 00:00:00,Lagos - Ikeja,792,1089,84,1965,,,670
2024-09-24 00:00:00,Lagos - Yaba,344,554,14,912,,,671
2024-09-24 00:00:00,Lagos - VI,181,316,15,512,,,672
2024-09-24 00:00:00,Lagos - Ago,198,315,47,560,,,673
2024-09-24 00:00:00,Lagos - Ajah,127,181,23,331,,,674
2024-09-24 00:00:00,Abuja - Utako,286,396,52,734,,,675
2024-09-24 00:00:00,Abuja - Mararaba,108,137,27,272,,,676
2024-09-24 00:00:00,Abuja - Lokogoma,192,297,37,526,,,677
2024-09-24 00:00:00,PHC,254,452,31,737,,,678
2024-09-24 00:00:00,Ibadan,330,520,63,913,,,679
2024-09-24 00:00:00,Ife,115,163,7,285,,,680
2024-09-24 00:00:00,Canada (Toronto),137,223,28,388,,,681
2024-09-24 00:00:00,Canada (Ottawa),28,28,4,60,,,682
2024-09-24 00:00:00,UK (Birm),57,97,11,165,,,683
2024-09-24 00:00:00,UK (London),92,143,4,239,,,684
2024-09-24 00:00:00,UK (Glasglow),30,31,2,63,,,685
2024-09-24 00:00:00,UK (Manchester),62,95,11,168,,,686
2024-09-24 00:00:00,Uyo,99,116,6,221,,,687
2024-09-24 00:00:00,Akure,66,80,9,155,,,688
2024-09-24 00:00:00,US-Dallas,22,28,0,50,,,689
2024-09-24 00:00:00,US-DMV,12,25,0,37,,,690
2024-09-24 00:00:00,Benin,55,73,0,128,,,691
2024-09-24 00:00:00,Ilorin,64,95,5,164,,,692
2024-09-24 00:00:00,Abeokuta,79,132,9,220,9805,,693
2024-10-01 00:00:00,Lagos - Ikeja,941,1293,101,2335,,,694
2024-10-01 00:00:00,Lagos - Yaba,377,581,22,980,,,695
2024-10-01 00:00:00,Lagos - VI,161,234,12,407,,,696
2024-10-01 00:00:00,Lagos - Ago,204,333,50,587,,,697
2024-10-01 00:00:00,Lagos - Ajah,126,192,18,336,,,698
2024-10-01 00:00:00,Abuja - Utako,310,396,56,762,,,699
2024-10-01 00:00:00,Abuja - Mararaba,120,158,31,309,,,700
2024-10-01 00:00:00,Abuja - Lokogoma,201,324,45,570,,,701
2024-10-01 00:00:00,PHC,378,539,24,941,,,702
2024-10-01 00:00:00,Ibadan,354,513,56,923,,,703
2024-10-01 00:00:00,Ife,138,169,4,311,,,704
2024-10-01 00:00:00,Canada (Toronto),161,231,27,419,,,705
2024-10-01 00:00:00,Canada (Ottawa),22,46,4,72,,,706
2024-10-01 00:00:00,UK (Birm),69,114,23,206,,,707
2024-10-01 00:00:00,UK (SE London),59,133,7,199,,,708
2024-10-01 00:00:00,UK (West London),45,73,6,124,,,709
2024-10-01 00:00:00,UK (Glasglow),29,30,1,60,,,710
2024-10-01 00:00:00,UK (Manchester),67,120,10,197,,,711
2024-10-01 00:00:00,Uyo,108,142,9,259,,,712
2024-10-01 00:00:00,Akure,61,63,9,133,,,713
2024-10-01 00:00:00,US-Dallas,21,33,3,57,,,714
2024-10-01 00:00:00,US-DMV,10,32,0,42,,,715
2024-10-01 00:00:00,Benin,44,73,5,122,,,716
2024-10-01 00:00:00,Abeokuta,89,155,12,256,10607,,718
2024-10-08 00:00:00,Lagos - Ikeja,856,1087,113,2056,,,719
2024-10-08 00:00:00,Lagos - Yaba,376,567,15,958,,,720
2024-10-08 00:00:00,Lagos - VI,175,297,23,495,,,721
2024-10-08 00:00:00,Lagos - Ago,222,333,58,613,,,722
2024-10-08 00:00:00,Lagos - Ajah,127,174,18,319,,,723
2024-10-08 00:00:00,Abuja - Utako,281,393,35,709,,,724
2024-10-08 00:00:00,Abuja - Mararaba,117,153,30,300,,,725
2024-10-08 00:00:00,Abuja - Lokogoma,209,298,40,547,,,726
2024-10-08 00:00:00,PHC,313,517,36,866,,,727
2024-10-08 00:00:00,Ibadan,351,548,43,942,,,728
2024-10-08 00:00:00,Ife,116,177,7,300,,,729
2024-10-08 00:00:00,Canada (Toronto),166,303,39,508,,,730
2024-10-08 00:00:00,Canada (Ottawa),36,60,8,104,,,731
2024-10-08 00:00:00,UK (Birm),70,105,16,191,,,732
2024-10-08 00:00:00,UK (SE London),65,127,9,201,,,733
2024-10-08 00:00:00,UK (West London),52,71,4,127,,,734
2024-10-08 00:00:00,UK (Glasglow),33,38,1,72,,,735
2024-10-08 00:00:00,UK (Manchester),71,113,13,197,,,736
2024-10-08 00:00:00,Uyo,110,131,12,253,,,737
2024-10-08 00:00:00,Akure,57,55,9,121,,,738
2024-10-08 00:00:00,US-Dallas,19,31,1,51,,,739
2024-10-08 00:00:00,US-DMV,14,28,1,43,,,740
2024-10-08 00:00:00,Benin,48,75,4,127,,,741
2024-10-08 00:00:00,Ilorin,69,68,1,138,,,742
2024-10-08 00:00:00,Abeokuta,72,155,9,236,10474,,743
2024-10-15 00:00:00,Lagos - Ikeja,785,946,95,1826,,,744
2024-10-15 00:00:00,Lagos - Yaba,358,507,17,882,,,745
2024-10-15 00:00:00,Lagos - VI,188,316,16,520,,,746
2024-10-15 00:00:00,Lagos - Ago,223,349,39,611,,,747
2024-10-15 00:00:00,Lagos - Ajah,134,180,13,327,,,748
2024-10-15 00:00:00,Abuja - Utako,297,398,57,752,,,749
2024-10-15 00:00:00,Abuja - Mararaba,105,146,32,283,,,750
2024-10-15 00:00:00,Abuja - Lokogoma,199,304,43,546,,,751
2024-10-15 00:00:00,PHC,394,528,42,964,,,752
2024-10-15 00:00:00,Ibadan,312,482,45,839,,,753
2024-10-15 00:00:00,Ife,113,162,7,282,,,754
2024-10-15 00:00:00,Canada (Toronto),157,206,40,403,,,755
2024-10-15 00:00:00,Canada (Ottawa),22,41,8,71,,,756
2024-10-15 00:00:00,UK (Birm),86,115,12,213,,,757
2024-10-15 00:00:00,UK (SE London),69,128,7,204,,,758
2024-10-15 00:00:00,UK (West London),50,72,3,125,,,759
2024-10-15 00:00:00,UK (Glasglow),36,35,1,72,,,760
2024-10-15 00:00:00,UK (Manchester),54,102,5,161,,,761
2024-10-15 00:00:00,Uyo,89,142,8,239,,,762
2024-10-15 00:00:00,Akure,43,70,7,120,,,763
2024-10-15 00:00:00,US-Dallas,17,25,1,43,,,764
2024-10-15 00:00:00,US-DMV,10,33,1,44,,,765
2024-10-15 00:00:00,Benin,48,84,4,136,,,766
2024-10-15 00:00:00,Ilorin,69,90,2,161,,,767
2024-10-15 00:00:00,Abeokuta,75,136,5,216,10040,,768
2024-10-22 00:00:00,Lagos - Ikeja,858,1187,104,2149,,,769
2024-10-22 00:00:00,Lagos - Yaba,303,457,19,779,,,770
2024-10-22 00:00:00,Lagos - VI,196,270,10,476,,,771
2024-10-22 00:00:00,Lagos - Ago,285,426,75,786,,,772
2024-10-22 00:00:00,Lagos - Ajah,134,172,21,327,,,773
2024-10-22 00:00:00,Abuja - Utako,392,493,61,946,,,774
2024-10-22 00:00:00,Abuja - Mararaba,106,158,28,292,,,775
2024-10-22 00:00:00,Abuja - Lokogoma,186,274,44,504,,,776
2024-10-22 00:00:00,PHC,337,485,40,862,,,777
2024-10-22 00:00:00,Ibadan,292,436,46,774,,,778
2024-10-22 00:00:00,Ife,115,170,5,290,,,779
2024-10-22 00:00:00,Canada (Toronto),149,215,36,400,,,780
2024-10-22 00:00:00,Canada (Ottawa),27,46,2,75,,,781
2024-10-22 00:00:00,UK (Birm),84,109,14,207,,,782
2024-10-22 00:00:00,UK (SE London),69,128,7,204,,,783
2024-10-22 00:00:00,UK (West London),46,85,6,137,,,784
2024-10-22 00:00:00,UK (Glasglow),37,31,1,69,,,785
2024-10-22 00:00:00,UK (Manchester),74,107,11,192,,,786
2024-10-22 00:00:00,Uyo,92,141,7,240,,,787
2024-10-22 00:00:00,Akure,49,75,6,130,,,788
2024-10-22 00:00:00,US-Dallas,19,34,3,56,,,789
2024-10-22 00:00:00,US-DMV,14,26,1,41,,,790
2024-10-22 00:00:00,Benin,43,85,2,130,,,791
2024-10-22 00:00:00,Ilorin,76,98,6,180,,,792
2024-10-22 00:00:00,Abeokuta,81,121,3,205,10451,,793
2024-10-29 00:00:00,Lagos - Ikeja,809,1139,93,2041,,,794
2024-10-29 00:00:00,Lagos - Yaba,382,514,10,906,,,795
2024-10-29 00:00:00,Lagos - VI,175,240,16,431,,,796
2024-10-29 00:00:00,Lagos - Ago,222,323,48,593,,,797
2024-10-29 00:00:00,Lagos - Ajah,159,166,15,340,,,798
2024-10-29 00:00:00,Abuja - Utako,430,514,65,1009,,,799
2024-10-29 00:00:00,Abuja - Mararaba,95,195,33,323,,,800
2024-10-29 00:00:00,Abuja - Lokogoma,211,296,41,548,,,801
2024-10-29 00:00:00,PHC,364,518,46,928,,,802
2024-10-29 00:00:00,Ibadan,281,474,52,807,,,803
2024-10-29 00:00:00,Ife,200,136,7,343,,,804
2024-10-29 00:00:00,Canada (Toronto),163,225,29,417,,,805
2024-10-29 00:00:00,Canada (Ottawa),22,35,6,63,,,806
2024-10-29 00:00:00,UK (Birm),82,118,19,219,,,807
2024-10-29 00:00:00,UK (SE London),76,143,6,225,,,808
2024-10-29 00:00:00,UK (West London),45,63,2,110,,,809
2024-10-29 00:00:00,UK (Glasglow),36,38,2,76,,,810
2024-10-29 00:00:00,UK (Manchester),77,116,8,201,,,811
2024-10-29 00:00:00,Uyo,116,168,7,291,,,812
2024-10-29 00:00:00,Akure,37,78,10,125,,,813
2024-10-29 00:00:00,US-Dallas,20,41,3,64,,,814
2024-10-29 00:00:00,US-DMV,13,28,0,41,,,815
2024-10-29 00:00:00,Benin,38,94,7,139,,,816
2024-10-29 00:00:00,Ilorin,61,69,4,134,,,817
2024-10-29 00:00:00,Abeokuta,67,111,6,184,10558,,818
2024-11-05 00:00:00,Lagos - Ikeja,741,988,91,1820,,,819
2024-11-05 00:00:00,Lagos - Yaba,387,590,21,998,,,820
2024-11-05 00:00:00,Lagos - VI,265,371,16,652,,,821
2024-11-05 00:00:00,Lagos - Ago,237,334,54,625,,,822
2024-11-05 00:00:00,Lagos - Ajah,132,166,18,316,,,823
2024-11-05 00:00:00,Abuja - Utako,371,532,52,955,,,824
2024-11-05 00:00:00,Abuja - Mararaba,100,152,31,283,,,825
2024-11-05 00:00:00,Abuja - Lokogoma,190,311,38,539,,,826
2024-11-05 00:00:00,PHC,318,465,41,824,,,827
2024-11-05 00:00:00,Ibadan,282,473,46,801,,,828
2024-11-05 00:00:00,Ife,111,136,5,252,,,829
2024-11-05 00:00:00,Canada (Toronto),180,267,36,483,,,830
2024-11-05 00:00:00,Canada (Ottawa),22,37,2,61,,,831
2024-11-05 00:00:00,UK (Birm),93,182,24,299,,,832
2024-11-05 00:00:00,UK (SE London),73,152,10,235,,,833
2024-11-05 00:00:00,UK (West London),42,60,4,106,,,834
2024-11-05 00:00:00,UK (Glasglow),42,37,1,80,,,835
2024-11-05 00:00:00,UK (Manchester),71,113,9,193,,,836
2024-11-05 00:00:00,Ireland (Dublin),68,91,6,165,,,837
2024-11-05 00:00:00,Uyo,113,147,8,268,,,838
2024-11-05 00:00:00,Akure,44,71,10,125,,,839
2024-11-05 00:00:00,US-Dallas,25,29,1,55,,,840
2024-11-05 00:00:00,US-DMV,18,31,1,50,,,841
2024-11-05 00:00:00,Benin,40,104,5,149,,,842
2024-11-05 00:00:00,Ilorin,59,87,2,148,,,843
2024-11-05 00:00:00,Abeokuta,69,122,7,198,10680,,844
2024-11-12 00:00:00,Lagos - Ikeja,956,1327,100,2383,,,845
2024-11-12 00:00:00,Lagos - Yaba,428,687,16,1131,,,846
2024-11-12 00:00:00,Lagos - VI,193,295,15,503,,,847
2024-11-12 00:00:00,Lagos - Ago,241,328,48,617,,,848
2024-11-12 00:00:00,Lagos - Ajah,141,180,18,339,,,849
2024-11-12 00:00:00,Abuja - Utako,394,562,62,1018,,,850
2024-11-12 00:00:00,Abuja - Mararaba,108,166,34,308,,,851
2024-11-12 00:00:00,Abuja - Lokogoma,231,326,42,599,,,852
2024-11-12 00:00:00,PHC,284,443,39,766,,,853
2024-11-12 00:00:00,Ibadan,309,534,41,884,,,854
2024-11-12 00:00:00,Ife,177,246,6,429,,,855
2024-11-12 00:00:00,Canada (Toronto),154,243,43,440,,,856
2024-11-12 00:00:00,Canada (Ottawa),26,38,3,67,,,857
2024-11-12 00:00:00,UK (Birm),58,121,17,196,,,858
2024-11-12 00:00:00,UK (SE London),72,130,5,207,,,859
2024-11-12 00:00:00,UK (West London),35,73,5,113,,,860
2024-11-12 00:00:00,UK (Glasglow),34,39,1,74,,,861
2024-11-12 00:00:00,UK (Manchester),61,116,10,187,,,862
2024-11-12 00:00:00,Ireland (Dublin),41,57,2,100,,,863
2024-11-12 00:00:00,Uyo,108,166,6,280,,,864
2024-11-12 00:00:00,Akure,60,65,9,134,,,865
2024-11-12 00:00:00,US-Dallas,19,31,0,50,,,866
2024-11-12 00:00:00,US-DMV,17,39,0,56,,,867
2024-11-12 00:00:00,Benin,40,87,7,134,,,868
2024-11-12 00:00:00,Ilorin,68,89,4,161,,,869
2024-11-12 00:00:00,Abeokuta,89,154,9,252,11428,,870
2024-11-19 00:00:00,Lagos - Ikeja,684,982,105,1771,,4267,871
2024-11-19 00:00:00,Lagos - Yaba,439,638,14,1091,,,872
2024-11-19 00:00:00,Lagos - VI,198,265,19,482,,,873
2024-11-19 00:00:00,Lagos - Ago,226,315,51,592,,,874
2024-11-19 00:00:00,Lagos - Ajah,128,182,21,331,,,875
2024-11-19 00:00:00,Abuja - Utako,372,477,116,965,,,876
2024-11-19 00:00:00,Abuja - Mararaba,102,145,17,264,,,877
2024-11-19 00:00:00,Abuja - Lokogoma,188,270,28,486,,,878
2024-11-19 00:00:00,PHC,314,460,38,812,,,879
2024-11-19 00:00:00,Ife,142,208,5,355,,,881
2024-11-19 00:00:00,Canada (Toronto),167,225,46,438,,,882
2024-11-19 00:00:00,Canada (Ottawa),26,35,3,64,,,883
2024-11-19 00:00:00,UK (Birm),63,126,13,202,,,884
2024-11-19 00:00:00,UK (SE London),74,135,12,224,,,885
2024-11-19 00:00:00,UK (West London),42,73,5,120,,,886
2024-11-19 00:00:00,UK (Glasgow),39,46,2,87,,,887
2024-11-19 00:00:00,UK (Manchester),76,106,12,194,,,888
2024-11-19 00:00:00,Ireland (Dublin),41,55,4,100,,,889
2024-11-19 00:00:00,Uyo,127,140,4,271,,,890
2024-11-19 00:00:00,Akure,57,76,5,138,,,891
2024-11-19 00:00:00,US-Dallas,19,31,1,51,,,892
2024-11-19 00:00:00,US-DMV,14,33,1,48,,,893
2024-11-19 00:00:00,Benin,50,92,2,144,,,894
2024-11-19 00:00:00,Ilorin,63,75,5,143,,,895
2024-11-19 00:00:00,Abeokuta,77,128,0,205,10339,,896
2024-11-26 00:00:00,Lagos - Ikeja,721,1000,126,1847,,,897
2024-11-26 00:00:00,Lagos - Yaba,327,566,12,905,,,898
2024-11-26 00:00:00,Lagos - VI,171,241,14,426,,,899
2024-11-26 00:00:00,Lagos - Ago,193,265,50,508,,,900
2024-11-26 00:00:00,Lagos - Ajah,118,169,16,303,,,901
2024-11-26 00:00:00,Abuja - Utako,320,438,65,823,,,902
2024-11-26 00:00:00,Abuja - Mararaba,96,121,23,240,,,903
2024-11-26 00:00:00,Abuja - Lokogoma,165,263,28,456,,,904
2024-11-26 00:00:00,PHC,351,428,46,825,,,905
2024-11-26 00:00:00,Ibadan,295,429,49,773,,,906
2024-11-26 00:00:00,Ife,132,195,5,332,,,907
2024-11-26 00:00:00,Canada (Toronto),160,227,37,424,,,908
2024-11-26 00:00:00,Canada (Ottawa),21,28,5,54,,,909
2024-11-26 00:00:00,UK (Birm),64,114,17,195,,,910
2024-11-26 00:00:00,UK (SE London),56,118,6,180,,,911
2024-11-26 00:00:00,UK (West London),38,67,2,107,,,912
2024-11-26 00:00:00,UK (Glasglow),24,41,1,66,,,913
2024-11-26 00:00:00,UK (Manchester),64,112,14,190,,,914
2024-11-26 00:00:00,Uyo,87,91,10,188,,,916
2024-11-26 00:00:00,Akure,41,64,10,115,,,917
2024-11-26 00:00:00,US-Dallas,22,30,2,54,,,918
2024-11-26 00:00:00,US-DMV,9,29,1,39,,,919
2024-11-26 00:00:00,Benin,36,71,5,112,,,920
2024-11-26 00:00:00,Ilorin,54,71,5,130,,,921
2024-11-26 00:00:00,Abeokuta,68,137,3,208,9500,,922
2024-12-03 00:00:00,Lagos - Ikeja,693,1079,129,1901,,,923
2024-12-03 00:00:00,Lagos - Yaba,397,630,10,1037,,,924
2024-12-03 00:00:00,Lagos - VI,151,237,11,399,,,925
2024-12-03 00:00:00,Lagos - Ago,203,296,51,550,,,926
2024-12-03 00:00:00,Lagos - Ajah,134,178,12,324,,,927
2024-12-03 00:00:00,Abuja - Utako,346,438,37,821,,,928
2024-12-03 00:00:00,Abuja - Mararaba,110,135,28,273,,,929
2024-12-03 00:00:00,Abuja - Lokogoma,184,295,27,506,,,930
2024-12-03 00:00:00,PHC,383,545,60,988,,,931
2024-12-03 00:00:00,Ibadan,287,458,46,791,,,932
2024-12-03 00:00:00,Ife,170,198,6,374,,,933
2024-12-03 00:00:00,Canada (Toronto),124,215,32,371,,,934
2024-12-03 00:00:00,Canada (Ottawa),19,29,7,55,,,935
2024-12-03 00:00:00,UK (Birm),102,56,13,171,,,936
2024-12-03 00:00:00,UK (SE London),53,113,6,172,,,937
2024-12-03 00:00:00,UK (West London),42,59,2,103,,,938
2024-12-03 00:00:00,UK (Glasglow),28,41,2,71,,,939
2024-12-03 00:00:00,UK (Manchester),125,198,13,336,,,940
2024-12-03 00:00:00,Uyo,131,173,8,312,,,942
2024-12-03 00:00:00,Akure,55,71,8,134,,,943
2024-12-03 00:00:00,US-Dallas,22,24,0,46,,,944
2024-12-03 00:00:00,US-DMV,12,27,0,39,,,945
2024-12-03 00:00:00,Benin,43,78,2,123,,,946
2024-12-03 00:00:00,Ilorin,55,79,4,138,,,947
2024-12-03 00:00:00,Abeokuta,69,129,4,202,10237,,948
2024-12-10 00:00:00,Lagos - Ikeja,715,837,104,1656,,,949
2024-12-10 00:00:00,Lagos - Yaba,374,542,19,935,,,950
2024-12-10 00:00:00,Lagos - VI,241,381,20,642,,,951
2024-12-10 00:00:00,Lagos - Ago,198,287,59,544,,,952
2024-12-10 00:00:00,Lagos - Ajah,182,133,9,324,,,953
2024-12-10 00:00:00,PHC,298,416,47,761,,,957
2024-12-10 00:00:00,Ibadan,270,429,29,728,,,958
2024-12-10 00:00:00,Canada (Toronto),127,213,30,370,,,960
2024-12-10 00:00:00,Canada (Ottawa),17,27,4,48,,,961
2024-12-10 00:00:00,UK (Birm),43,71,10,124,,,962
2024-12-10 00:00:00,UK (SE London),87,145,11,243,,,963
2024-12-10 00:00:00,UK (Glasglow),35,40,2,77,,,965
2024-12-10 00:00:00,UK (Manchester),54,102,11,167,,,966
2024-12-10 00:00:00,Uyo,94,136,9,239,,,968
2024-12-10 00:00:00,US-Dallas,24,28,0,52,,,970
2024-12-10 00:00:00,US-DMV,11,25,1,37,,,971
2024-12-10 00:00:00,Benin,37,67,2,106,,,972
2024-12-10 00:00:00,Ilorin,57,96,5,158,,,973
2024-12-10 00:00:00,Abeokuta,65,112,6,183,7715,,974
2024-12-17 00:00:00,Canada (Toronto),114,179,30,323,,,986
2024-12-17 00:00:00,Canada (Ottawa),19,31,1,51,,,987
2024-12-17 00:00:00,US-Dallas,22,27,0,49,,,996
2024-12-17 00:00:00,US-DMV,11,24,3,38,,,997
2024-12-17 00:00:00,Abeokuta,31,65,-,96,614,,1000
2024-12-24 00:00:00,Lagos - Ikeja,865,1233,184,2282,,,1001
2024-12-24 00:00:00,Lagos - Yaba,293,417,29,739,,,1002
2024-12-24 00:00:00,Lagos - VI,161,223,20,404,,,1003
2024-12-24 00:00:00,Lagos - Ago,197,311,35,543,,,1004
2024-12-24 00:00:00,Lagos - Ajah,110,169,16,295,,,1005
2024-12-24 00:00:00,PHC,256,362,40,658,,,1009
2024-12-24 00:00:00,Ibadan,240,369,34,643,,,1010
2024-12-24 00:00:00,Ife,90,105,2,197,,,1011
2024-12-24 00:00:00,Canada (Toronto),180,275,40,495,,,1012
2024-12-24 00:00:00,Canada (Ottawa),19,33,1,53,,,1013
2024-12-24 00:00:00,UK (Birm),99,165,35,299,,,1014
2024-12-24 00:00:00,UK (SE London),115,234,14,403,,,1015
2024-12-24 00:00:00,UK (Glasglow),41,40,2,83,,,1017
2024-12-24 00:00:00,Ireland (Dublin),28,35,1,64,,,1019
2024-12-24 00:00:00,Uyo,97,114,6,217,,,1020
2024-12-24 00:00:00,Akure,45,63,8,116,,,1021
2024-12-24 00:00:00,US-Dallas,21,30,0,51,,,1022
2024-12-24 00:00:00,US-DMV,11,22,0,33,,,1023
2024-12-24 00:00:00,Benin,48,68,2,118,,,1024
2024-12-24 00:00:00,Ilorin,72,57,6,135,,,1025
2024-12-24 00:00:00,Abeokuta,61,134,15,210,8038,,1026
2024-12-31 00:00:00,Lagos - Ikeja,897,1174,159,2230,,,1027
2024-12-31 00:00:00,Lagos- Yaba,613,815,15,,,,1028
2024-12-31 00:00:00,Lagos-Ago,268,371,53,692,,,1029
2024-12-31 00:00:00,Lagos-Ajah,118,196,23,337,,,1030
2024-12-31 00:00:00,Lagos - VI,156,211,17,384,768,,1031
2024-12-31 00:00:00,PHC,233,335,63,,,,1035
2024-12-31 00:00:00,Ibadan,215,312,32,559,,,1036
2024-12-31 00:00:00,Akure,56,76,9,141,,,1037
2024-12-31 00:00:00,Ile Ife,53,71,2,126,,,1038
2024-12-31 00:00:00,Uyo,90,111,13,214,,,1040
2024-12-31 00:00:00,UK (SE London),110,196,26,332,,,1041
2024-12-31 00:00:00,Abeokuta,64,93,11,168,,,1044
2024-12-31 00:00:00,Canada (Toronto),174,224,24,422,,,1045
2024-12-31 00:00:00,US-Dallas,27,46,1,74,,,1046
2024-12-31 00:00:00,Canada (Ottawa),33,38,10,81,,,1047
2024-12-31 00:00:00,Ireland (Dublin),26,34,3,63,,,1050
2024-12-31 00:00:00,US-DMV,5,9,0,14,,,1051
2024-12-31 00:00:00,Benin,38,56,4,98,5935,,1052
2024-12-31 00:00:00,Lagos - VI (Overture),364,437,4,805,,,1053
